Good Morning=Bonjour
This is a test=Ceci est un test
Name=Nom
Last name=Nom
First name=Pr&eacute;nom
CSS Registration Form=Formulaire d'Inscription CSS
Registration=Inscription
Account Details=D&eacute;tails du Compte
Email=Courriel
Repeat email=Re-Saisir le couriel
Password=Mot de passe
Repeat Password=Saisir &agrave; nouveau mot de passe
obligatory fields=champs obligatoires
Personal Details=D&eacute;tails obligatoire
Name=Nom
Phone=T&eacute;l&eacute;phone
Street=Rue
City=Ville
Country=Pays
United States=&Eacute;tats Unis
Website=Site web
Further Information=Plus d'information
Gender=Sexe
Male=Masculin
Female=F&eacute;min
Birthdate=Date de naissance
January=Janvier
February=F&eacute;vrier
March=Mars
April=Avril
May=Mai
June=Juin
July=Juillet
August=Aout
September=Septembre
October=Octobre
November=Novembre
December=Decembre
Nationality=Nationalität
Helpful Information=Nützliche Informationen
Children=Kinder
Here comes some explaining text, sed ut perspiciatis unde omnis iste natus error sit voluptatem accusantium doloremque laudantium, totam rem aperiam, eaque ipsa quae ab illo inventore veritatis et quasi architecto beatae vitae dicta sunt explicabo.=Hier kommt ein erklärender Text, sed ut perspiciatis unde omnis iste natus error sit voluptatem accusantium doloremque laudantium, totam rem aperiam, Eaque ipsa quae ab illo inventore veritatis et quasi architecto beatae vitae dicta sunt explicabo .
Terms and Mailing=Nutzungsbedingungen und Benachrichtigungen
I accept the=Ich akzeptiere die
Terms and Conditions=AGB
I want to receive personalized offers by your site=Ich möchte persönliche Angebote von Ihrer Webseite erhalten
Allow partners to send me personalized offers and related services=Senden Sie mir personalisierte Angebote und Dienstleistungen von Partnern
Register=Registrieren